4 0 0 0 0 2 8 0 9
3 1 2 0 0 9 0 6 7
0 7 9 1 5 6 0 0 4
0 0 3 5 0 7 6 9 8
9 8 4 6 3 1 7 2 5
0 0 7 2 9 8 0 4 1
7 3 0 9 6 4 1 5 2
0 4 1 0 2 5 9 8 3
2 9 5 8 1 0 4 7 6

0,0,7,0,3,5,8,6,0
0,6,0,4,0,9,2,3,5
3,9,5,0,2,6,1,4,7
0,0,0,2,8,3,6,0,1
6,0,2,9,5,1,3,7,0
0,1,3,7,0,4,5,0,2
8,0,1,0,4,7,0,0,6
4,2,0,6,1,0,0,5,3
7,3,6,5,9,2,4,1,8

